###############                                                                                     
#B            #                                                                                     
###### # ######                                                                                     
#    #   #    #                                                                                     
####### ##    #                                                                                     
# A           #                                                                                    
###############   