###############
#B     #      #
###### # ### ##
#    #   #   B#
# ## #####   A#
# A#          #
###############